'en	en
-ce	ce
-ci	ci
-elle	il
-elles	il
-en	en
-il	il
-ils	il
-je	il
-la	le
-le	le
-le	le
-les	le
-les	le
-leur	lui
-leur	lui
-lui	lui
-là	là
-moi	lui
-même	même
-même	même
-mêmes	même
-mêmes	même
-nous	il
-on	il
-t	t
-toi	lui
-tu	il
-vous	il
-y	y